


1111111111111C11111111111111111111
100000000000000C00000C000100000001
110011110010000010100100010001010C
1P1100001010101000100100010000000E
C010010010101010001001000100010101
1010010010101010001001000100000001
1010010010101010001001000100010101
1010001010101010001001000100010101
100001000C00C0000000000000010000C1
1111111111111111111111111111111111






