


1111111111111111111111111111111111
1E0000000000000C00000C000100000001
1100111100100000101001000100010101
1P11000010101010001001000100000001
1010010010101010001001000100010101
1010010010101010001001000100000001
1010010010101010001001000100010101
1010001010101010001001000100010101
101001000C00C0000000000000010000C1
1111111111111111111111111111111111






