


1111111111111111111111111111111111
1E0000000000000C00000C0001000000X1
1100111100100000101001000100010101
1P11000010101010001001000100000X01
1010010010101010001001000100010101
1010010010101010001001000100000X01
1010010010101010001001000100010101
1010001010101010001001000100010101
100001000C00C000000000000001000XC1
1111111111111111111111111111111111






