
1111111111111111111111111111111111
1E0000000000000C00000C000100000001
1100111100100000101001000100010101
1P11000010qwerytreytreuopbvcxg0001
1010010010101010001001000100010101
10100100134566789900-=-fffffffff01
1010010010101010001001000100010101
1010001010101010001001000100010101
100001000C00C3gbf000000000010000C1
1111111111111111111111111111111111