111111111111111111111111111111111111111111111111111111111111
1E0000000000000C00000C00010000000000000000000000000000000001
110011110010000010100100010001010000000000000000000000000001
1P1100001010101000100100010000000000000000000000000000000001
101001001010101000100100010001010000000000000000000000000001
101001001010101000100100010000000000000000000000000000000001
101001001010101000100100010001010000000000000000000000000001
101000101010101000100100010001010000000000000000000000000001
100001000C00C0000000000000010000C000000000000000000000000001
100001000C00C0000000000000010000C000000000000000000000000001
100001000C00C0000000000000010000C000000000000000000000000001
100001000C00C0000000000000010000C000000000000000000000000001
100001000C00C0000000000000010000C000000000000000000000000001
100001000C00C0000000000000010000C000000000000000000000000001
100001000C00C0000000000000010000C000000000000000000000000001
100001000C00C0000000000000010000C000000000000000000000000001
100001000C00C0000000000000010000C000000000000000000000000001
100001000C00C0000000000000010000C000000000000000000000000001
100001000C00C0000000000000010000C000000000000000000000000001
100001000C00C0000000000000010000C000000000000000000000000001
100001000C00C0000000000000010000C000000000000000000000000001
100001000C00C0000000000000010000C000000000000000000000000001
100001000C00C0000000000000010000C000000000000000000000000001
100001000C00C0000000000000010000C000000000000000000000000001
100001000C00C0000000000000010000C000000000000000000000000001
100001000C00C0000000000000010000C000000000000000000000000001
100001000C00C0000000000000010000C000000000000000000000000001
100001000C00C0000000000000010000C000000000000000000000000001
100001000C00C0000000000000010000C000000000000000000000000001
100001000C00C0000000000000010000C000000000000000000000000001
100001000C00C0000000000000010000C000000000000000000000000001
100001000C00C0000000000000010000C000000000000000000000000001
100001000C00C0000000000000010000C000000000000000000000000001
111111111111111111111111111111111111111111111111111111111111