1111111111111111111111111111111111
1CCCCCCCCCCCCCCCCCCCCCCCC1CCCCCCC1
11CC1111CC1CCCCC1C1CC1CCC1CCC1C1C1
1P11CCCC1C1C1C1CCC1CC1CCC1CCCCCCC1
1C1CC1CC1C1C1C1CEC1CC1CCC1CCC1C1C1
1C1CC1CC1C1C1C1CCC1CC1CCC1CCCCCCC1
1C1CC1CC1C1C1C1CCC1CC1CCC1CCC1C1C1
1C1CCC1C1C1C1C1CCC1CC1CCC1CCC1C1C1
1CCCC1CCCCCCCCCCCCCCCCCCCCC1CCCCC1
1111111111111111111111111111111111