

1111111111111111111111111111111111111111111111111111111111111
1E0000000000000C00000C000100000000000000000000000000000000001
1100111100100000101001000100010100000000000000000000000000001
1P11000010101010001001000100000000000000000000000000000000001
1010010010101010001001000100010100000000000000000000000000001
1010010010101010001001000100000000000000000000000000000000001
1010010010101010001001000100010100000000000000000000000000001
1010001010101010001001000100010100000000000000000000000000001
100001000C00C0000000000000010000C0000000000000000000000000001
1111111111111111111111111111111111111111111111111111111111111